P P P W P S P P P P
P P P P W W W P P P
P P P P E P W P P P
W P P P P P P P W P
P P P P W P P P P P
P P P P P P P P W W
G P W P P W P P P P
P W P P W P P P P W
P P W P P P W P P W
P P P P W P P P P P
