W W P P V W P P W P W W W P Q P W P P P W P P W P P P P P W P P P P P P W P W P P P P P P P P P P P P P P P P P W P B P P P P P P P W P P P P P W P P P W P W P P P P P W P P P P W W W W P P P P P W P
W P W P P W P W P P P P P P W P P P P W P P W P P P P W W P P W W W P P P Y P P W P P P P P P W W P W P P P P P W P P W P P P P P P P W P W P P P P W P W P P W P P P P P P P P W P W P P P P P W P W P
P P P W W P P P P P W P P P P W P P P P W W P P P C P P W P P W P P P P P P P P P W P W P P P P W W W P P W W P P P P W P W W P P P W P P P P W P W W H P P P P W P W P P P C P P W P W P W P P P P P P
W P P P W P W P P P P W P P P P P W P W X P W P W J P W P P P P P W P P P P P P P P P W P P P P P P P P P W P P P P P P W W W P P W W P P P P W P P W P P P P P P P P P W P P W P P P W P P W P P R W P
P P P P P P P P P W P W P P W W P W P P P P W W P P P W W W W P W W P P W P P P P P W W P P P W W W P W W P P P W P P P W P P P P P P W W P P P P P P W P W W P P P P W P P P P W P W P W W P P P P P P
P W P E P W P P P P P P W P W P P W P W P W P P P P W P P W W W P P P P P W P W W P W P P P P W P P W P P W P W P P W P W P P W W P P P W W W P W P P W R P P P P M P P W W W P W P P W P P W P P W W P
W P P P P P W W P W W W P W P P P P P P W P P P W W W P W P P W P W W P P P P P P P P W P P W W P P W W W P W P P P P W P P P P P P P W P W W P W P P P P P P P P P P P C N P P P P P P P P P P P P P P
W P P W P P P P P P W P W W P P W P W P W P W P P W W Q P W P P W P W P P P P P W W P P W W W P P W W W P W M W P W P P P P W W P W P P W P W P P W W P P P N W P P P W P P P P P P P W W P W P P P P P
P P W W P W P P P P W J P P P P W W W P W P P P W P W W P P P P P P P P P P P W P P P P P W W W P W P P P P P P P W P W P P P P P W P P W P P W W P P P P P W P P R P P P W P W P P W P W W W P P P P P
C P P P P P W P W P P P P P P P P P P W P P P P P P W P P P P P P P W W P P P P P P P W P W W P P W P P W W P P P P W P P P P P P P P P P P P P P W P P P P P P W W W W P P P W P P P P W W P P P P P P
W P P P P P P W P P P P W W W W W P P P P P P P P W P P P P W W W W P P P P P P W P P P P P W P P P W P P P P P W P P W W W P P P P P W W P W H P P P P P P P W P P P P W P J W P P P W P P P P W P W W
P P W P P W W P P W P W P P P W P P P P P W P P P W P P P O P W P P W W P P P P P P W W P W W W W P P P P P P P P P P W P P P P W P P W P P P P P W W W P P P P P M P P P P W P W P W W W P P W P W P W
S W P P W W P P W W W P P P P P P W P P P P P P P P P P P P C W W P P W P P W P W P P P W P P W P P P W P P W P P P P P P W P P P W P P P P P P P W P P P W P P W W W P W W W W P P P P P P P P P P P P
P P P W M W P W P P P P W P W P P P P P P W P P W P P P W P P P W P P P H P P P W W P P P P W W P P P P P P P W W W W P W P P W W W W P P P W W W P W W P P P W P W W W W P P E P P P W P W P P W P P P
P P W P W W P P P P P W W W P P P P P P P P P P P P P W W P W W P W P P P P P P P P W P P W P P P P P P W P W W P P W P P P P P P P W P P W P P W P P W P P P W P P P P P P P P P P T P P W P P W P W P
W W W P P W W W U P P P W P P W P P P P P P P P W W P P W W P W P P W P P P P P W P P P P P W P P P P P P W W W W W P P P P P P W P W P W W P P P W P P P P P P W P W P P W W P P P P P W P P W W W P W
W P W P P P P P P P W P W P P P P P P P P P W P P P P P P P P W P W P P P P W P W P P W W P W P P P W P P P P W W W P P P R W P P P P P P P W P P P P P P P P P W W P W Y W W P P P P P P P P P W P P P
Q P W P W P W P W P P P W P L W P P P P W P P P P P W P P P P W P P P P W P W W P P P P P P P P W P W W P P P W P P W P P P W P W P P X P P P P P P W C P W P P W P W P P W P P P W W W P W P P P W P P
P P P P W W P P W T P P P P P P W P P W P P P W W W P W P P W P W P P P P P P P P P P P W W W P P P P P W W P W P P P P V P W W P P P P W W P W P W P P P P P P W P P P P W P P P P W P P W W P W P W P
W W W W W W D P P P P W P P P P P P P P W P P P W W P P P P P P P P P P P P W P P P P P W C P P U P P P P F P P P P P P W W P P P P W P P P W P P W P P P P P P W P P P P P W P P W W P P P P P P O P W
P P P P P W P P P P P P W W P W W P P P W W P W P W P W P W P P W W P P W P W P P P P P W P P W W P W W P P W P P P W P P P P P P P W P P W Y P W P W W P P P P P W P W P W P O W W W P P P P P P P P W
P P W W W P P W P W P P P P P P P P P W P P P P P P W P W W W P W P W W W P W W W P P P P P P W W P P P W W P P P P P P W P P P P P P P P W P P P P P W W P P W W P W P P P T W P P P P W P P P W W P P
P P P P P P P P W P W P P P W W W P W P P P P P P P P P W P P P P W P P P W W P P P P P W P P W Y P W P P E W W P P P W P P W P P W P W P P P W P W P Y P P P W P W P P P P B P P W W P P P P W P W P P
P P P W W P P P P W P W P P P P P W P P W P P P W P W P P P P P P P P P W W W P P J P P W P W P P W P P P P W P W P P P P P P P P W P W W P P T P W P P W P W P P P P P P W P P P P P P W P P P P P P P
P P W P P P W P P P P P P P P P P P P P W P P P P P W P P P P P W W W P P P P P P W P P W W W P P W P W W W P W P P P W P P P P P P P P W P W P P P W P W W W P W P P P P W P P P P P P P P W P P W P P
W W W P P P P W P W P P W P P W P P W P P P P P P W P P P W P P P W W W P W P P P P P P P P W P W P P P P P P W W P P P P P P W P P W P W P P W P P P P P P P P P P P P P P P P P P P P P W X W P P P P
P P P P P P P P W W W P W W P P P W P P P W P P P P W P P W P P P W W P P W W W Y W P P P W W W W P P P P W P W P P P W P P P P P W P P P P P W P P P P A P P W P P P W P P X B P P W W P P W W D P W P
P P P W P W P P P P W P W P P P P W P W P W W P P P W P P L P P P P W W P M P P W W W W P P P P X P P P P P P P P P P W P P P W W P P P W P W P W P P P P P P W R P P P P P P W P P P P P P P P P P P P
P W P P P P P W P P W W P O P C P P P P P P P W W W P W P P W P W P P K P P P P W W W P P W P W P W W P P W P W P W P W P P W P W P P W P W P D P W P P W W P P W W P P W P P W P P P P P W P P P P P P
P P P P P P P P W P W P W P W P P P W W P P P P W P P P P P P P P P P P P P W P W W W P P P P P P P P W P P P P P P P P P P W P W P P P P P P W P W W W W P W P P P W P P W W P P P W W P P P P P P P P
P P P P P P W W P P W P P P P W P P P P P W P W J W P P P P W L P U W P P P P P P P P P P P P P P P P P P P W P P P P P P P W P W W W P P W P P P P P P W P P P P P P P P P P P P P P P P P P P P P P W
W P W P P P P W P P W P P P P P W P P P P P P P Q P P W W P P R P W P W W W P W P P P P P P P P P P P P P P P P W W W P W P P P P W P P P P W P P W P P P W P P P W P P P J W P P P W P P P P P W P P W
W P W P P P P P P B P W P P W P P P P P P P P P P R P P P W W P P P W P P P P P P W W P P P W P P W P P W P P W P P P P W P P P P P W P W W P P P P P P P W P W P W P W W P W P C P P P P P P W W P P P
P P P W P P W P W W W W P W P P P P P P P P P P P P P P P P W P P W P P W P P W P P W P P W W P W P P W W P P P W P P P W W W P P P P P P W P P P P P P P P P P P P P W P P P P W P P W P P P P P P W P
P P P W P P P P P W P W P P P P P W P K P P P P W P P P P P P W P P P W W W W P W P W P P P W P P P P P P P W P P P P W W P W W P P P W W P P P P P W W W P P P P P P P P B P P P P P W P P P W P W P P
P W W P P P W P P P P P P W P P C P W P W W P P P P P P P P P W P W P P P P P P W P P P P P P P P P P W P P P P P W P P Y P P P P W P W W P P P W P W P P P P P W P P P W W P P W P P W P W P P P P P P
W P P W P W P P P P P P W W P P W P P W W P P P W P P P P P W P W W P P P P P P W W P P P W P P P P W P P P P W P P P P P P W P P W P P P W P W P P P P P P P P P R P P W P W P P W P W W W W W P P P P
P P P W P W W W P P P P W W P P P P P W P W P N P P P P P P P P W P P P P W W P W P P P P W P W P P P P P P P P W P W P P W P P W W W P P P W P W P P W P P P P W P P P P P P W P P P P P W P W T W P P
P N W W P W P P W P P W P P P P P P E W W W W W P W P P W P W P P P P P P P P P P P W P P P W P P P P P P W P P P P P P W W P W P W W W P P P W W W P W P P P P P P W P P P W P P P W W P P P W W P P P
P P P P W P P P A P P W P W W P A P P W W P P Q P W W W P P P T P W W P P P W P P P P P P P W P P P W W W W P V W P P W P P P P P P P P W P P P P P P P W P W P W P W P P P P P W P P P P P P P P P P P
P P W P P P P P P P M W W P W P P P P W W P W P P P W P P P P W P P P P W W W P W W P P P P P P P P P P P P P P P W W P P W P P P P W P P P P P P P W P P W W P P P W P P P W P P W P W P P P W W P P P
P W W P W W P W P P W P W P W P P P P P P P P P P P P P W P W P W P P W P P P P P P P W P W P P W P W P P W P W P P P W P P P W P P P P W P P P P P W P W P P P W P P P P P W P P P W P P W P P W P W W
P W P W P P P P P W W P W P P W P W P P P P W P W W P W P W W W P P W W W P P P W P W L W W W W W P W W P P P P P P P P P P P P P P P P H P P P P P W P P P P W P P P W P P Y P W P P W W W W W P P P P
P W P P P P P P P P P P P W P P P P P W W W P P P W W P P P P P P P P P P P W P P W W P W W P P P P P P W W P P W W P P P W P W P P P P P P W Q P P W P P P P P P P P P W W P W P P W P P P P W W P P P
P P P P P P W P P W W P P W P W Y P P P P P W P P P P P W W P P W P P P P P W P P P P P P P P P L P P W P P P W P P P P P P P P P P P P P W W P W P P P P P W P P P W P P P P W P P P W P P P P P P P P
H P W P W P W W W P P P P W P W P P P P P W P P P P P P W W W W W N P W P P W P A P P W P W W W W P P P W P P W P P W W P W P P P W P P P P P P P P P P P P P P W P P P W P P P P W W P W P P P W P W W
W P P W P W P P W P P P W W P P P P P P P P P P P P P P P W P P W P P P P P P P W W W W W W P P W P P W P P W W W P P P P P W P P P P W P W W W P W P P P P P P P P W P P P P W P P P P W P P P P P P P
P W W P W P P P P W P P W P P P P P W W Y W W P P P T P P P W W P W P W P P W P W P W P P P P P W P P P W P P P W C P P W W W P P W P W W P P P W P W P P P P P W P P W P W P P P W P W P P W P P P P W
P P P P E P P W W W P P P D P P W P P P P P P P P W P P P P P W P P P W P P P P P P P P P P W P P P P W P W W P P P P P P P W P P P P P P P P W P W W X P P P P P P P P P P P P P P P W P W P P P P P W
P P W P P P P P P W P P W P P P P P P W W P P W P W P P L W W P W W P P W W P P W P P P P W P P W W P W P P P W P P W P W P P P P P P W P W W P P P P W P P W W P P P W W P W W P P P P P W P W P P P P
W P P P W W P P P K P P P W P W P P P P W P P P P P P P P W W W P P P P E P P P P W P P P P P P P P W P P P W P W P P P W P P P W P P W P P P P P P W P P P P W P W W W P P P P P P W P P P P P W P P P
P W W P W P W P W P P W P W W P W P W P P W P W W P P W P P P P P P W P P W W P P P P P P W P P P P P P P P P P W M P W P W W W W P P P W P P W P P W P W P W W P W P P P P P P P W P W P P P W W P P P
P P P P P P P W W P P P P W W P P P W P P P W P P P P P P W P P P P W P W W P P P P P P P P P P P P W P P P W P P P P P P W P P W P P W W P P P P P P W R P P P P P P P P P P P P P P P P P P P P P W P
W W P P P W P P W P C P W W W W W P P P P W P W P P P P P P P P W W P P P P W P P P W P P P P P P W P P W P P P P W P P P P P P P P P W P P P P P P W W P W P P W W P P W W P W W P P P P P P W W P P P
W W P P P W W W P P P P P W P W P P P W P P P P P W P P P P P P W P P P P W P P P P W W P P P P W W W P P P P P W P W P P P P P P P P W W P P P W P W P P P P P W P P W W P W P P P P W P P P P W P P P
W P W P P P P P P P P W W W W P P P P P P P P P W P P P W P W P P P W P P P W P Q P P W P W P W W P P P W P W P P P P P P P P P P P P P W P P P P P P W P W P W P P W P P P P P P P P P P P W P P P P P
W W P P P P P P P P P W P W T P P P W W P P P P P P P P P W P P W P P P W P P P P W W P W W P P P P P P P P W P P P P P P P P I W P W P O P P P P P P P W P W P W W P P W W P P W P W P W P P P P P W P
P M P P P P P P P P P W P P P P W P P P P P P W W P P W P W P W P P P W P P W P H W P P W W P P P P P P P W P W W P W P P P P P P P W P P P P P P P P P P W P P P W P P P P P W W W P P P W P P P P W W
P P P P P P P P P W P W P W P P P W W P P W P W P P P W W P P P P P P W P P P P P P W P P W P W W P P P P W W P W W P A W W W W W W P P P W P P P P W P W P P P N W P P P P P P W P W P W P P P P P P W
P P P P P P P P P P W P W W W P P P P P M P P L W P W W W P P P W W P W W P W P P W P P P P P P P W P P P P P P W W P P P P P W P W P W W W P Q P W W P W W P P P P P P P P W P P P P P P P W P W P P P
P W W P P P P W W P P W W W P W W P P P P W P W P A P P P P P P P P P P P P W P P P W P P W W P P P P W P P P P P P P W P W P W P P P P P P P P W P P W P P P P W P P P W P P P P P P P W P P W W P W W
P W P P P P P P P P H P W P X W P P P P W P P W P P P P P P P W P P W P P P U P P W P P P P W W P P W P P P P P W P P W P P P P W P P P P P P P W P P P P P W P P P P P W P P W W P W W P P P P P P P P
D W P P P P Q P P P P P P P P P P W P W P P W P W W P P W P P P W P W P P W W P W W P W P P W W P P P P P P P P P P R W W W P W P P P P P P P P P W W W P W P W P P W P P W P P W P P P W P W P W P P P
P P P P P W P P W P P H P P W P P P P W P P P W P P P P W P P P P P P P P P P P P P P W P Y P P W P P P P P P W P P P P P B P P P P P W P P P P P P W W P W P W P W P P P W P P W P P P W P P W P P P P
P W W P P P P P P P W P W P W W W P P W W P P P W P P P W W P P P P P P P P P W W W P P P W W W P P W P P P W P P P P P P P W Q P P P W P P P P W P P P P P W P P P P W W P P P P P P P P P W P P P P W
P P P P P P P W W P P W P P P W P P W P W A P W P P P P W W P W P P P P P W W W P W P P P W W P W W P W P P P W P P P W P W P P W P P W P W W W P P P W W W W P P P P P P W P P P P W W W W W P J P W P
P W P P P P P P W P P W P P P P P W P P P P P W P P P P P P P W P W P P D P W P T L P P P P P W P P P P P P P W P W W W W P P W W P P P W E W P P P P W W P P P P P P P P P W W R P W P W P P P P W W P
P F P P P P P W P P P P P P P W W P P W P W W W P P W P P P E W W P P P P P P W W P P P P P P P W P W P P P P W W W W P P P P W W P P P W P P P P P W W P W P P P P W P P P P P W P P W P P P P P P P W
W P P W P W P P P P P W W P P W P P P P P P P P P W P P P P P P W W P P P P W W W P W P W P W W W P P W P W B P P P W P P P P W P W P P P P W P P P P P P W W P P P W P P P W P P W P P P P P P D P W W
W P P P P P P P P P P P P P W P W P P W W P P P P P P P W W W P P P P W P W P P P P P P P W P W P W P W P P P P P P P P P P P W W W P W P W P P W P P W P W P P P P P W W W W P P P P P P P W P W W P W
P P P P P P P P P W P P P W P P P P P W W P P P P P P P W W P W P W W W P P P P P W Y W P P W P P P W W P P P P P W W W W P P W P P W P P P W W P W W P P P W P P P P P W W P P W P P P P P O W W P P P
P W P W P P P P W P P P W P H P P W W P P P P W W P P P W P P P P P W L P W P P P P P P P W P W P P P P P P W P P P P P P P P W W P W P P P W P P W P P P W P W P P W W F P P W P W P P P P W P W P P W
P P P P P W P P W P W W W W P P P P P P P P P P P P W P P W P P P P W W W P P P P W P P P P P W W P W P P W P P P P P P W W W W W P W P P W P P P P P P P P P W P U P P P P A W P P W P P W W W P P P P
W W P P P P W P W P P P P W P P P W P P P W P P P P P P W W P P P P P W P P P W P W P W P P P P W P W P W P P P W P W P W W P P P P P P P P P W P W P P W P P P P P P W N P P P P P P P P W P P W P P P
P P W W P P P W P W P P V W P P P P W W P P W P P P P P P P P P W P P P P W P W P W P P W W P P P P P P P W P P W W P P W W W P P W P W P P P P P P P P W P P P P P P P P P P P P W W P P W W P W P P W
P P P P P W P P P W P P W P W W W P P P P P P W P P W W W P P P P P P P P P P P W W P W P P P W P P P P P P W P P P W P P P P W W P P W P P W P P P W P P W W O P Y W P W P P P P W W P W W P P P P P P
P W P P W P P P W P P P W P W W P P P P W W P W P W P W P P W W W P W W P P P P P P W P W P P W P P P P W W P P P P P W P P W P P P W P P P P W W W P W P W P P P P P P P P P P P P W P P P P P W W W P
P P P P P P P W P W F P P P P W P W P P P P P P P P P P P W P P W P P P P P P P P P P P P W W P W W W W W W P P W W W P P P P I P P W P P P W P P P W P W W P P P P P W P W W P P P P P P P P P P P P P
P P P P P P W P P P T W P W P P W P P P P P P P U P P W P P P P P P P P P W P P W P W P P P W M W W P P P P W P P P P P P P P P W P W W P W P P P P P P P P W W P P W P P P E P P W P W P W P P P P W P
P P P P P W W P P W P P P W W W W P P P P W P P W P W W P P P W P P P W P W P P P P P P P P P P P W P W P P P P P P X P W P P P P P P P W W P W P P W P P P W P W P P P P P P P P P W P P P P P P P P P
P P W W W P P W P P P P W P P P P P P W P W P P P P P P P P P W W W W W P P P P W P P W L P W P P P P P P W P W W P P W W P W P P P W P P P P P P H P P W W W P P P P P P W P W P P P P P W P P P P P P
P W P P P W P P P P P W P P W P W W P P P W W W P P W P P P P P P P P W W P W P P P V P W Y P P P W P P W P W P P P P P W P P P P P P P P W P P W P P W W W P W P W W P P P W P P W W P W W W P P P W P
P P P P P W W P P P W P W P P P P P W P P W P P P P P P P P P P P P P P W W P P W W P P P P W P W P P W W W P W P P P P P P P P W P W P P P P P U P P P W P W P P P W P W P P P W P W W P P R P P W W P
P P R P W P P P W P P P W P P W W P P P P W P P P P W P P P W P P W P P P W P W W P W P P P P P W P W W P P U P W P P W P P P P P W P P P P P P P P P P W W P P P W W W W P W P P P P P W P W P W P P P
P P W W P P W B P P P P P P P P P W W P P P W P P W P W P A P W P P P P P P W W P P P W P P P W P P W P W P P W P W P W P P P P W W P P P P P P W P W P P P P P W W W W W P P P P W W P P P P P C V P P
P W P P P W P P W P W L P W W P P P P W W W P W P P W W P P P W W P P P P P P P W A P P P P P P P W P P P P P P P P P P P P P P W P W P P P P P P P P P P W P P P P W W P P P P P P P P W W W W P P P P
W P P W W P P P P P P W P P P W P P P P P P P P P W P P P P W P P P P P E P W P P P P P W P P P P P P P W P P P P P P W P P P P W W P P W W P W P W W P W P P P P P P P P W P P P P P P W P P P P Q P W
W P P W P P P P W P P P P W P P P P W P W P P W J P P P P P P P W W W W W K P P W P P P W P P P P P P P W P P P W W P P P W P P W P P P P P P W P P P P I P W P P W P P P W W P P P W P P P P W W P P P
P P P P W Q W W P P P W P L P P P W P W W W P P W W W P P P P P P W P P W W P W W W W P P P P P P P P W P P P P P P P P P W P W P P P P W P W P P P W P W W W P P W P P W P P W P P P P P P W P W P P P
P P P P P P P P W W P N W P P W P W P P P P P P P P W P P P P P P W Q P P P P P W P P P P P W P P W P P P W P P P H P P W P P P P P P P K E P W P P P W W W P P W P P P R P P P P W P P P P P P P P P P
P W W W P W W W P P P P P P P L P P P P P P P P P P W P P P P P P P P P W P W P W P J P W W W P P P P P P P P P P W H P P W P P P W P P P P W P P P W P W P P W P W W W W W P P P W P P P W P P P W W P
P P P W P P P P P W P P P P W P P P W W P P P P P P P P P W P P W P W K P P P P W P P P P P W P P P P P P P W P P W W P W P P P P P P P P P P P W P P W P P W P W W W W P W P W P P P W P P P W W P P P
P W P P W P P P P P W P P P P W P P P P P P W P W P P P P P P W P P P P W W P P W P P P W P P W W P P P W P P P P P P P P W P P P P P A W P P W P W P P P P W P P P P P W P P P X P P P P P P P P W P P
P W W P P P P P P P P W P P P W P W P P P P W W P P P W W P P P W X P P P P W P P P P W P W P P P P P P W P P W P W P W P P W P W P W P P P P P W P P P P W P P W P P P W P P P P P P E P P P P P X W P
P P P W W P P A W P W P P P P P P P P P P P W P P W P P W W P P P P P W P P P P P P P P P P P W P P P P W W I P W W A P W P P K P P W P W P P W W W P P W P W P W P P P P P P P W P P P W W P W P W W P
P P P P W P P P W P W P P W P W P W P P P P P T P W P W P P P P W P P P P P W P P P P P P P W L W P P W F P P W W P W P W P W P W W P P W P W P P W P P P W W W P W P P P P P W P W P P P P W P W P P P
P W W P P P W P W W P P P P W P W P P P W P W P P W P W P P P P P W P P P P P P P P P P P P P P W W P P P W P P P P W P W P P P P W W P P P P P P P P W W W P W P P P P W P P P P W P P P P P P W P Q P
P P P P W P W P P P P W P W P W W P P P P P P P P P P P W P W P P P P P P P W P P W P W W P W P P P W P P W W P P P P P W P P P P W P W W W P W W P P P P P W P W P P P P W P P P R W P P P W P W P P P
W P P P P P W P P P W W P P W W P P P W P W P P P P P P P P P P P P P P P P P W P P P W P W W P W P P P P P W P P P P W P P W P P W P W P W P W W P W W U W W P P P P P P P P P P P P D W W W P P P P W
P P P W P P P P P P P P P W P P P W P W W W P P G P P P P P P W P W P P P P W P P P W W W P P P P W P P P W W P P P W W W T P P W P W P P P W P P W P P W C P W P P P P W P W P P W P P P W P P W P P P
