P P P P P P W P W P P W P W P W P W P P P P P P W P P W P P W W W P W P P P P P W W P P W P P P S W
W P P P P P P W W P W P P P P P P P P P P W W P P P P P P W W P P P P P W P P K W P W P P W W P P P
P P P P P P W P P W P P P W P W P P W W P P P P P P P D P P A W W P P P P P W W P P P W P P P P W P
P W W W P P P W W P P W N W P W P P P P P V P P W P P P W W W P P W P P P P W W P P P P W P P L P P
W P P W P P P P P W P P P W P P P P P P P W P P P W P P P P W P P P P P P W P P P P P P P P W P P P
P P W P W W P W W P P W P I P P P P W P P P P P W P W P P W W P P P W W P P P W W P P P W P W W W P
P P W W W P P P P P P P P P P P P P P W P P P P P P W P W W P W W W P W P P P P W W W P W P P W P P
W P P W F W P P P W W K P W P W P P W W W W P W P W P P P P W W P W P P P P P W W P W P L W W W W W
P P P P P P W W W P P W P P P P P P P W W P P W P P P P P W W P W P P P P W P P W W P P P P P P P W
P W W P P P P P P W P P P W P W W W P P P P W P P P P P P P P P P P W W P W P P W P W W P W P W P W
P P P W W W P W W W P P P W W W P P W W P P W P P P P P P P P P W P W P W P P P W P P P P W P P P P
P W P W P P P P P P P P P W W W W P P P W W W P P W P W W W P P P P P P P P P W P P P P P W P P W P
P W P W W W P P A P P P W P P P P P W P P W P W P P W P W P P P W P P P W W W P W P W P P P P P P P
W P W C P P P P P P P W P P P P P P P P P W P Q P P P W W P P W P P P P P P W P P W P W W P W P P W
P P W P P P W P P W P P P W P W P P P P P W P P W W W P W P P P W W P P P P P W P P P P W W W P P W
P W W P P P P P W P P P P P W F W P P P P P P P P W W W P P P W P P P W P P W P P P P W P P W P P P
W W P P W P P P P P W P P P P W P P W W P P P P P P P W P W P P P W W W P P P P W P W I P P P P W W
P P P P P W P P P W P W P P P P W P P P W W P P P W P P W W W P P P P P P P P P W W W P P P I P P P
W W P P P P P W P P P P P P P P P P P P P P P P W P P P P P P P P P W P P P P P P P W P W P P P W P
W P P P P P P W P P P P P P P P P P W W P W P W W H W P P P P I P P P P P P W P P W P P P W P P P P
P P P W P W P L P P P P P P W W P P W P W P P P W P P W P W P P P P P W P P W W P P P W P P P P W W
P P P P P W W W P P P P P W P P P W P P W W A P P P P P P P P P P W W W W P P P W P P P P P P P P J
P P P P P P P P W P P P W P P W P P P P P W P P P P P W P P P W P P P P P W W W P P W P P P P P W P
P P P W P P W P P P P W P P P P P W W P P W X P P P P W W P W P P W P W P W W P P P P P P P W P P P
C W W P P P W P P P P P P W P P P P P P P P P W P P P P P P P P P W W P P P P W P P W P W P P W P P
P P P P P W P P W P P P W P P P W P P P P P P P W P P P W P W P P W P P P P W W W P P P P P P P P P
W P W W P P P P P P W P W W W P P W W W P P P P W W P P P W P P P P P W W W P W R P P W P P W P P P
P W P P W P P P P W P P P P P W W W P W W P P W P P P P W P P P P P W W P P P P W P W P P P P P W W
P P P P P P P W P P W W W W P W W W P W W P P P W W P P W P P W P P P P P P P P P W W W W P P P P W
W N W P P P W P P P P W W P P P W W W P P W P P P P P P P W W P P W P P P P P P P P P P P W P P W P
W W P W W W W P W P P W P P P P P P P P P P P W P W P P P W P P W W W P P P W P P P P P W W P P P P
P P W P W W W P P P P P P W P P P P P P P P P W P W P P W P P P P W W P W P W P W P P W P P P P P W
W P P P W W P W W P W P P W W P W W P P P P P W W P W W W W W W P P P W P P P W P P W P P P P P P P
P W P P P W P P P A P P P P P P P P P Q W P P P P W P P W P P P W W W P W W P P P P P D W P P P P H
W P P P P W P P P P W P P M P P P P W W W P W P P P W P W V P P W W P P P I P W W P W W W P P W P P
W W P P P P W W W P H P P P P P P P W W W W P P P W P W P P P P W W P P W W P P P P P P P P P W P P
P P P P P W P P P W W P P P P P P W W W P P W P W W P W P P R Y P W P P W P P R W P W P P P P P W P
W P P P P W P P W W P P W P P P P P P P B P P W P P P W P P W P P W P P P P P P W P P P P P P P P P
P P W W P P P P P W P W W P P W W W P P P P P P W W W P P P W P P P P P P O W P P W P P P P P P P P
P P P P P W W P P P W W P P P P W W P W W W W W W P P W W W P P W W W P W P P P P P P P P P P W P P
W P P P P W P P W W P P W P W W W P W P P P P P W P P P P P W W W P W P P P F P P W W P P P P P P P
P P P P P P P W P P P W P W P P P P P W W W W W P P P P P P W P P P P P P P W P P W P W P P W W P P
P P W P P P P P W P P P P W W P W P W W P W P P P W P P P P P P P P W W P P P P P P P P W P P P W P
P W W W W P W W P P W W W W P P P P P W P P W P P P W W W W W P W W P W W P P P P P P P W W W W P W
P W P W W P P P W W P P W P P P P W W W W W W P P P W P W P P W P P P P P P P P P P W P W P W W P P
P P R P P P P P P P P P W P P P W P P P P P P P P P W W W P P P P P P P W P P P O W P W W P P P P P
P P P P P P P P P P P P P P W P P P P P W W P P P W W P W P P P P P W N P P P P P P P P P W P P P W
W N W P W W P P W P P P P W P W W P W W W W P P W W P P W W P P P W P W P W W P P W W P W P P P P P
P P W P P P P W P U P P Q P P W P W P W P P W W W W W P W W P P W P P P P W P W P P W P P P P P W P
W P G W W P P P P P P W P W W P W W P P P P P P W W P P P P P P P P P P P P P P W P P P P W P P W P
